{
    "W_001": 0,
    "W_002": 1,
    "W_003": 2,
    "W_004": 3,
    "W_005": 4,
    "W_006": 5,
    "W_007": 6,
    "W_008": 7,
    "W_009": 8,
    "W_010": 9,
    "W_011": 10,
    "W_012": 11,
    "W_013": 12,
    "W_014": 13,
    "W_015": 14,
    "W_016": 15,
    "W_017": 16,
    "W_018": 17,
    "W_019": 18,
    "W_020": 19,
    "W_021": 20,
    "W_022": 21,
    "W_023": 22,
    "W_024": 23,
    "W_025": 24,
    "W_026": 25,
    "W_027": 26,
    "W_028": 27,
    "W_029": 28,
    "W_030": 29,
    "W_031": 30,
    "W_032": 31,
    "W_033": 32,
    "W_034": 33,
    "W_035": 34,
    "W_036": 35,
    "W_037": 36,
    "W_038": 37,
    "W_039": 38,
    "W_040": 39,
    "W_041": 40,
    "W_042": 41,
    "W_043": 42,
    "W_044": 43,
    "W_045": 44,
    "W_046": 45,
    "W_047": 46,
    "W_048": 47,
    "W_049": 48,
    "W_050": 49
}